3222222222222222222224
3000000000000000000004
3000000000000000000004
3700000000000000000004
3:00000000000000000004
3000000000000000000004
3000000000000000000004
3000000000000000000004
3000000000000000000004
300000;000000000000804
300000::::00000000:::4
30000000000000000:0004
30000000000000000:0004
30::::00000000000:0:04
3000000000000000000:04
30000000<0009000000:04
300000::::0:::00000:04
300000000:000000000004
3000000000000000000004
3000000000000000000004
3000000000000000000604
3111111111111111111114