.--------------------/
.00000000000000000000/
.00000000000000000000/
.20000000000000000000/
.60000000000000000000/
.00000000000000000000/
.00000000000000000000/
.00000000000000000000/
.00000000000000000000/
.00000700000000000030/
.00000666600000000666/
.00000000000000006000/
.00000000000000006000/
.06666000000000006060/
.00000000000000000060/
.00000008000400000060/
.00000666606660000060/
.00000000600000000000/
.00000000000000000000/
.00000000000000000000/
.00000000000000000010/
.,,,,,,,,,,,,,,,,,,,,/